111111111111111111
111110000P00111011
1000C000C111100001
111C0000000C000011
1111C000C0C0000001
110000000000000111
1111000E1111100001
111111111111111111