1111111111
1000E11111
1X00C00001
10C0C0C001
10000X1111
1P00011111
1111111111