11111111
1000E111
10000001
10C0C0C1
10000111
1P000111
11111111 