111111111111111111111111
11110000C011110E00111111
10000111000C000011111111
100000000000011110000111
100000001110000011000011
10000C00000000P000000011
100010011111100000111111
10000C00111100C000110001
111100000C0000C000110001
111111111111111111111111