111111111111111111111
100001E000000P0000001
1000C0100C00000011111
1100000111100000C0111
11100C000000C00011111
1111C0000001110000001
1000000C00000000C0001
1000C0C0C0C0000000001
111111000111111111111
10C00000000C000C00001
111111111111111111111