111111111111111111111111111111111
111110E1111111110000000C000000001
1110000011111000000111000000C0111
110000000111111000000000111111111
111100000000C000011110000000C0001
11000000111110000000C000000000111
11100000000000P111000000000011111
11000011110000000000C000000011111
11100000C00011100000000C000001111
111100000111110C00011111000000001
111111111111111111111111111111111