111111111111111111111111111111
111110E11111111100X0000C000001
111000001111100000011100000011
11000X000111111000000000111111
111100000000C000011110000C0001
11000000111110000000C000000111
11100000000000P111000000X00111
11000011110000000000C000000111
11100000C00011100000000C000011
111100000111110C00011111000001
111100000111110C00011111000X01
1111000X0000110000011111000001
111100000001110000011111000001
111111111111111111111111111111