111111111
100C00C01
10000C001
1000000E1
1000000P1
10000C001
111100111
110001111
110C01111
111111111