1111111111111111
1000000100001111
1111100000001110
1111111000000011
1111111111111111