111111111111
100P000E0001
110000000001
111111111111