111111111111
100000C00001
100000E11111
111111111111