1111111111111111
1000C0010E001111
111110P000001110
1111111000000011
1111111111111111